Merhaba = Guten Tag
Günaydın = Guten Morgen
Tünaydın = Guten Abend
İyi günler = Guten tag
İyi akşamlar = Guten abend
İyi geceler = Gute nacht
Teşekkür ederim = Danke sehr
Bir şey değil = Nicht zu danken
Nasılsınız = Wie geht es ıhnen
Sağolun,iyiyim = Danke gut
Evet = Ja
Hayır = Nein
Hanım = Dame
Bey = Herr
Lütfen = Bitte
Afedersiniz = Entschuldigen Sie
Acıktım = Ich bin hungrig
Susadım = Ich habe durst
Kayboldum = Ich bin verloren
Tamam = Einvestanden
Önemli = Wichtig
Acele = Eilig
İmdat = Hilfe
Hoşgeldiniz = Willkommen sie
Hoşbulduk = Danke sehr
Güle güle = Schüs
Anlıyorum = Ich verstehe
Anlamıyorum = Ich verstehe nicht
Biliyorum = Ich weiss
Bilmiyorum = Ich weiss nicht
İstiyorum = Ich möchte
İstemiyorum = Ich möchte nicht
nasılsın = Wie geht es Ihnen