böylelikle = thus
başıboş dolaşmak = wander
kekelemek = stammer
mesele = issue
ulaşmak = reach
haykırmak = exclaim
sebep olmak = occasion
el koymak = appropriate
göstermek = indicate
bilinçli = conscious
sezgisel his = intuitive sense
bu yüzden = hence
reklam sloganı = tagline
yaşlı = elder
becerikli = resourceful
acınası = pathetic
neşelendirme = exhilarating
paçavra = shred
hazırlamak = prepare
boyutluluk = dimensionality
kararlı = decisive
sınır = boundary
muamele etmek = treat
kilo vermek = lose weight
diyet yapmak = on a diet
görselleştirme = visualization
veri ambarı = data warehouse
yığın = stack
sonuç = consequence
kalıcı = permanent
zararlı = harmful
tüketici = consumer
fiyatlandırma = quotation
yedeklemek = back up
yazar = author
ilişki = association
artırmak = increase
alan = domain
ev sahibi = host
işleme = processing
tahmin etme = predict
sınıflandırma = classification
bardak = glass
güvenilir = confidential
şahsi olarak = proprietarly
